#############
#           #
#     s   m#
#   #######b#
#  ## 
#
##
###
####
     #
       #########
